5 5
#####
#S  #
# #D#
#  E#
#####