15 15
###############
#S            #
#### ## ##  # #
#       #   # #
# #####    ## #
# #D          #
# ###   ### D #
# #   # #   # #
# # ### #   # #
# # #   # #   #
#   ### # # ###
# D         # #
# #####  #  # #
#            E#
###############
