15 15
###############
#S            #
# # ## D# #   #
#D      # # # #
### # ##  ##  #
#     # #     #
### #   ##  # #
# # # # #     #
# # # # # ##D##
#       #     #
##    # #   # #
# #      D# # #
# ####   #  # #
#    D       E#
###############
