7 7
#######
#SD   #
# D   #
# DD  #
# DDDD#
# D  E#
#######
